21
21
wwBBBBBBBwwwBBBBBBBww
wBBwwwBBBBwBBBBwwwBBw
BBwwwwwBBwwwBBwwwwwBw
BwAAAAAwBBBBBwAAAAAwB
wwAwwwAwwwwwwwAwwwAww
wAAAAAAAAAAAAAAAAAAaw
wAwwwAwwwAwAwwwAwwwAw
wAwAAAwAAAAAwAAAwwAAw
wAwwwAwwwAwAwwwAwAAAw
wAAawAwAAAAAAAwAwAAAw
wAwwwAwwwAwAwwwAwwwAw
BAAAAAAAAAAAAAAAAAAAB
wwwAwwAwBXXXBwAwwAwww
BwwAAAAwBBBBBwAAAAwwB
BBwAwwAwwwwwwwAwwAwBB
BBwAwwAAAAAAAAAwwAwBB
BBwaAAAwwwAwwwAAAawBB
BwwAwwAwwwAwwwAwwAwwB
BwwAwwAwwwAwwwAwwAwwB
wwwAAAAAAAAAAAAAAAwww
wwwwwwwwwwwwwwwwwwwww
