21
21
wwBBBBBBBwwwBBBBBBBww
wBBWWWBBBBwBBBBWWWBBw
BBWWWWWBBwwwBBWWWWWBB
BWAAAAAWBBBBBWAAAAAWB
WWAWWWAWWWWWWWAWWWAWW
WAAAAAAAAAAAAAAAAAAaW
WAwwwAWWWAWAWWWAwwwAW
WAwAAAAAAABAAAAAwAwAW
WAwwwAwwwAwAwwwAwwwAW
WAwaAAwAAAwAwAAAwAwAW
WAwwwAwAWAwAwwwAwAwAW
BAAAAAAAAAAAAAAAAAAAB
WWWAWWAWBXXXBWAWWAWWW
BWWAAAAWBBBBBWAAAAWWB
BBWAWWAWWWWWWWAWWAWBB
BBwAWWAAAAAAAAAWWAwBB
BBwaAAAWWWAWWWAAAawBB
BwwAwwAwWWAWWwAwwAwwB
BwwAwwAwwWAWwwAwwAwwB
wwwAAAAAAAAAAAAAAAwww
wwwwwwwwwwwwwwwwwwwww